Job,Operation,Arrival,Deadline,Machine,Start,Processing Time,End,Lateness,Tardiness,Earliness
Job_064,9,4803,6347,M3,5760,79,5839,-508,0,508
Job_074,1,5561,7100,M1,5767,78,5845,-1255,0,1255
Job_067,4,5156,6708,M4,5785,32,5817,-891,0,891
Job_072,3,5442,6787,M5,5787,61,5848,-939,0,939
Job_068,4,5205,6763,M2,5811,85,5896,-867,0,867
Job_060,6,4514,6486,M7,5815,85,5900,-586,0,586
Job_062,8,4619,6280,M4,5817,6,5823,-457,0,457
Job_061,9,4551,5730,M6,5820,53,5873,143,143,0
Job_069,3,5260,6713,M9,5820,11,5831,-882,0,882
Job_065,8,5021,7071,M4,5823,26,5849,-1222,0,1222
Job_059,8,4463,6223,M9,5831,45,5876,-347,0,347
Job_069,4,5260,6713,M3,5839,69,5908,-805,0,805
Job_070,1,5431,6963,M1,5845,2,5847,-1116,0,1116
Job_075,1,5660,7124,M0,5845,13,5858,-1266,0,1266
Job_071,3,5436,7449,M4,5849,99,5948,-1501,0,1501
Job_058,9,4402,5880,M8,5850,30,5880,0,0,0
Job_076,0,5760,7445,M0,5858,29,5887,-1558,0,1558
Job_070,2,5431,6963,M5,5875,52,5927,-1036,0,1036
Job_076,1,5760,7445,M1,5887,78,5965,-1480,0,1480
Job_068,5,5205,6763,M9,5896,11,5907,-856,0,856
Job_075,2,5660,7124,M2,5896,61,5957,-1167,0,1167
Job_066,5,5053,6670,M9,5907,76,5983,-687,0,687
Job_068,6,5205,6763,M6,5908,40,5948,-815,0,815
Job_072,4,5442,6787,M3,5908,26,5934,-853,0,853
Job_077,0,5842,7628,M0,5923,43,5966,-1662,0,1662
Job_070,3,5431,6963,M3,5934,95,6029,-934,0,934
Job_071,4,5436,7449,M6,5948,9,5957,-1492,0,1492
Job_072,5,5442,6787,M4,5948,69,6017,-770,0,770
Job_071,5,5436,7449,M8,5957,52,6009,-1440,0,1440
Job_074,2,5561,7100,M2,5957,9,5966,-1134,0,1134
Job_075,3,5660,7124,M6,5957,7,5964,-1160,0,1160
Job_067,5,5156,6708,M6,5964,88,6052,-656,0,656
Job_069,5,5260,6713,M1,5965,28,5993,-720,0,720
Job_073,1,5443,7256,M0,5966,85,6051,-1205,0,1205
Job_076,2,5760,7445,M2,5966,9,5975,-1470,0,1470
Job_077,1,5842,7628,M2,5975,90,6065,-1563,0,1563
Job_056,9,4220,6028,M7,5983,45,6028,0,0,0
Job_066,6,5053,6670,M5,5983,47,6030,-640,0,640
Job_079,0,5954,7513,M1,5993,81,6074,-1439,0,1439
Job_072,6,5442,6787,M8,6017,21,6038,-749,0,749
Job_071,6,5436,7449,M7,6028,85,6113,-1336,0,1336
Job_074,3,5561,7100,M3,6029,36,6065,-1035,0,1035
Job_070,4,5431,6963,M8,6038,48,6086,-877,0,877
Job_069,6,5260,6713,M6,6052,46,6098,-615,0,615
Job_073,2,5443,7256,M3,6065,39,6104,-1152,0,1152
Job_080,0,5991,7465,M2,6065,14,6079,-1386,0,1386
Job_074,4,5561,7100,M4,6070,49,6119,-981,0,981
Job_080,1,5991,7465,M0,6079,6,6085,-1380,0,1380
Job_080,2,5991,7465,M1,6085,22,6107,-1358,0,1358
Job_067,6,5156,6708,M8,6086,19,6105,-603,0,603
Job_070,5,5431,6963,M9,6086,72,6158,-805,0,805
Job_069,7,5260,6713,M5,6100,46,6146,-567,0,567
Job_066,7,5053,6670,M3,6104,52,6156,-514,0,514
Job_075,4,5660,7124,M8,6105,64,6169,-955,0,955
Job_073,3,5443,7256,M2,6107,74,6181,-1075,0,1075
Job_082,0,6097,7328,M1,6107,46,6153,-1175,0,1175
Job_072,7,5442,6787,M7,6113,49,6162,-625,0,625
Job_074,5,5561,7100,M5,6146,11,6157,-943,0,943
Job_078,0,5903,7793,M1,6153,91,6244,-1549,0,1549
Job_060,7,4514,6486,M3,6156,98,6254,-232,0,232
Job_074,6,5561,7100,M6,6157,62,6219,-881,0,881
Job_080,3,5991,7465,M5,6157,61,6218,-1247,0,1247
Job_070,6,5431,6963,M0,6158,47,6205,-758,0,758
Job_069,8,5260,6713,M7,6162,72,6234,-479,0,479
Job_072,8,5442,6787,M9,6162,72,6234,-553,0,553
Job_073,4,5443,7256,M8,6181,90,6271,-985,0,985
Job_081,0,6059,6952,M2,6181,84,6265,-687,0,687
Job_059,9,4463,6223,M4,6190,33,6223,0,0,0
Job_082,1,6097,7328,M0,6205,37,6242,-1086,0,1086
Job_070,7,5431,6963,M6,6219,65,6284,-679,0,679
Job_066,8,5053,6670,M4,6223,90,6313,-357,0,357
Job_075,5,5660,7124,M9,6234,76,6310,-814,0,814
Job_078,1,5903,7793,M0,6244,85,6329,-1464,0,1464
Job_071,7,5436,7449,M3,6254,98,6352,-1097,0,1097
Job_062,9,4619,6280,M7,6255,25,6280,0,0,0
Job_083,0,6243,6909,M2,6265,31,6296,-613,0,613
Job_073,5,5443,7256,M5,6271,10,6281,-975,0,975
Job_081,1,6059,6952,M1,6278,2,6280,-672,0,672
Job_073,6,5443,7256,M7,6281,12,6293,-963,0,963
Job_081,2,6059,6952,M5,6281,52,6333,-619,0,619
Job_068,7,5205,6763,M7,6293,89,6382,-381,0,381
Job_073,7,5443,7256,M6,6293,89,6382,-874,0,874
Job_079,1,5954,7513,M2,6296,95,6391,-1122,0,1122
Job_060,8,4514,6486,M9,6310,22,6332,-154,0,154
Job_070,8,5431,6963,M4,6313,6,6319,-644,0,644
Job_083,1,6243,6909,M0,6329,86,6415,-494,0,494
Job_067,7,5156,6708,M9,6332,48,6380,-328,0,328
Job_075,6,5660,7124,M5,6333,47,6380,-744,0,744
Job_081,3,6059,6952,M3,6352,95,6447,-505,0,505
Job_071,8,5436,7449,M9,6380,22,6402,-1047,0,1047
Job_068,8,5205,6763,M4,6382,26,6408,-355,0,355
Job_074,7,5561,7100,M7,6382,56,6438,-662,0,662
Job_077,2,5842,7628,M4,6408,75,6483,-1145,0,1145
Job_079,2,5954,7513,M0,6415,71,6486,-1027,0,1027
Job_083,2,6243,6909,M1,6415,46,6461,-448,0,448
Job_060,9,4514,6486,M5,6433,43,6476,-10,0,10
Job_067,8,5156,6708,M7,6438,36,6474,-234,0,234
Job_074,8,5561,7100,M8,6444,44,6488,-612,0,612
Job_082,2,6097,7328,M3,6447,61,6508,-820,0,820
Job_083,3,6243,6909,M5,6476,74,6550,-359,0,359
Job_077,3,5842,7628,M9,6483,11,6494,-1134,0,1134
Job_084,0,6461,8189,M0,6486,76,6562,-1627,0,1627
Job_081,4,6059,6952,M8,6488,48,6536,-416,0,416
Job_085,0,6493,8187,M1,6493,85,6578,-1609,0,1609
Job_080,4,5991,7465,M3,6508,26,6534,-931,0,931
Job_082,3,6097,7328,M2,6508,13,6521,-807,0,807
Job_082,4,6097,7328,M6,6521,32,6553,-775,0,775
Job_077,4,5842,7628,M3,6534,69,6603,-1025,0,1025
Job_073,8,5443,7256,M9,6545,45,6590,-666,0,666
Job_083,4,6243,6909,M4,6550,32,6582,-327,0,327
Job_052,9,3996,6613,M5,6570,43,6613,0,0,0
Job_084,1,6461,8189,M1,6578,69,6647,-1542,0,1542
Job_085,1,6493,8187,M0,6578,13,6591,-1596,0,1596
Job_079,3,5954,7513,M4,6582,99,6681,-832,0,832
Job_083,5,6243,6909,M6,6582,88,6670,-239,0,239
Job_081,5,6059,6952,M9,6590,72,6662,-290,0,290
Job_085,2,6493,8187,M2,6591,61,6652,-1535,0,1535
Job_067,9,5156,6708,M3,6611,79,6690,-18,0,18
Job_082,5,6097,7328,M5,6613,21,6634,-694,0,694
Job_066,9,5053,6670,M7,6625,45,6670,0,0,0
Job_069,9,5260,6713,M8,6640,30,6670,-43,0,43
Job_077,5,5842,7628,M1,6647,28,6675,-953,0,953
Job_086,0,6596,8188,M2,6652,31,6683,-1505,0,1505
Job_087,0,6645,8266,M0,6668,76,6744,-1522,0,1522
Job_083,6,6243,6909,M8,6670,19,6689,-220,0,220
Job_079,4,5954,7513,M6,6681,9,6690,-823,0,823
Job_080,5,5991,7465,M4,6681,69,6750,-715,0,715
Job_068,9,5205,6763,M8,6689,74,6763,0,0,0
Job_083,7,6243,6909,M9,6689,48,6737,-172,0,172
Job_076,3,5760,7445,M3,6690,36,6726,-719,0,719
Job_085,3,6493,8187,M6,6702,7,6709,-1478,0,1478
Job_078,2,5903,7793,M3,6726,39,6765,-1028,0,1028
Job_072,9,5442,6787,M6,6734,53,6787,0,0,0
Job_082,6,6097,7328,M9,6737,32,6769,-559,0,559
Job_083,8,6243,6909,M7,6737,36,6773,-136,0,136
Job_081,6,6059,6952,M0,6744,47,6791,-161,0,161
Job_087,1,6645,8266,M1,6744,69,6813,-1453,0,1453
Job_076,4,5760,7445,M4,6750,49,6799,-646,0,646
Job_085,4,6493,8187,M8,6763,64,6827,-1360,0,1360
Job_075,7,5660,7124,M3,6765,52,6817,-307,0,307
Job_078,3,5903,7793,M2,6783,74,6857,-936,0,936
Job_077,6,5842,7628,M6,6787,46,6833,-795,0,795
Job_076,5,5760,7445,M5,6799,11,6810,-635,0,635
Job_075,8,5660,7124,M4,6817,90,6907,-217,0,217
Job_080,6,5991,7465,M8,6827,21,6848,-617,0,617
Job_083,9,6243,6909,M3,6830,79,6909,0,0,0
Job_088,0,6700,8130,M0,6830,43,6873,-1257,0,1257
Job_077,7,5842,7628,M5,6833,46,6879,-749,0,749
Job_081,7,6059,6952,M6,6833,65,6898,-54,0,54
Job_079,5,5954,7513,M8,6848,52,6900,-613,0,613
Job_080,7,5991,7465,M7,6848,49,6897,-568,0,568
Job_089,0,6871,7715,M2,6871,84,6955,-760,0,760
Job_086,1,6596,8188,M0,6873,86,6959,-1229,0,1229
Job_090,0,6876,8860,M1,6876,81,6957,-1903,0,1903
Job_076,6,5760,7445,M6,6898,62,6960,-485,0,485
Job_078,4,5903,7793,M8,6900,90,6990,-803,0,803
Job_081,8,6059,6952,M4,6907,6,6913,-39,0,39
Job_087,2,6645,8266,M3,6909,76,6985,-1281,0,1281
Job_081,9,6059,6952,M7,6913,25,6938,-14,0,14
Job_070,9,5431,6963,M7,6938,25,6963,0,0,0
Job_091,0,6882,7875,M2,6955,14,6969,-906,0,906
Job_089,1,6871,7715,M1,6957,2,6959,-756,0,756
Job_086,2,6596,8188,M1,6959,46,7005,-1183,0,1183
Job_089,2,6871,7715,M5,6959,52,7011,-704,0,704
Job_079,6,5954,7513,M7,6963,85,7048,-465,0,465
Job_088,1,6700,8130,M2,6969,90,7059,-1071,0,1071
Job_091,1,6882,7875,M0,6969,6,6975,-900,0,900
Job_084,2,6461,8189,M3,6985,76,7061,-1128,0,1128
Job_065,9,5021,7071,M8,6997,74,7071,0,0,0
Job_093,0,7001,8577,M0,7001,29,7030,-1547,0,1547
Job_085,5,6493,8187,M9,7003,76,7079,-1108,0,1108
Job_091,2,6882,7875,M1,7005,22,7027,-848,0,848
Job_078,5,5903,7793,M5,7011,10,7021,-772,0,772
Job_086,3,6596,8188,M5,7021,74,7095,-1093,0,1093
Job_078,6,5903,7793,M7,7048,12,7060,-733,0,733
Job_088,2,6700,8130,M4,7059,75,7134,-996,0,996
Job_090,1,6876,8860,M2,7059,95,7154,-1706,0,1706
Job_078,7,5903,7793,M6,7060,89,7149,-644,0,644
Job_089,3,6871,7715,M3,7061,95,7156,-559,0,559
Job_082,7,6097,7328,M8,7071,89,7160,-168,0,168
Job_074,9,5561,7100,M9,7079,21,7100,0,0,0
Job_075,9,5660,7124,M7,7079,45,7124,0,0,0
Job_091,3,6882,7875,M5,7095,61,7156,-719,0,719
Job_094,0,7100,9082,M1,7100,85,7185,-1897,0,1897
Job_076,7,5760,7445,M7,7124,56,7180,-265,0,265
Job_086,4,6596,8188,M4,7134,32,7166,-1022,0,1022
Job_088,3,6700,8130,M9,7134,11,7145,-985,0,985
Job_087,3,6645,8266,M5,7156,51,7207,-1059,0,1059
Job_091,4,6882,7875,M3,7156,26,7182,-693,0,693
Job_089,4,6871,7715,M8,7160,48,7208,-507,0,507
Job_086,5,6596,8188,M6,7166,88,7254,-934,0,934
Job_080,8,5991,7465,M9,7173,72,7245,-220,0,220
Job_082,8,6097,7328,M7,7180,30,7210,-118,0,118
Job_079,7,5954,7513,M3,7182,98,7280,-233,0,233
Job_092,0,6883,8754,M1,7185,91,7276,-1478,0,1478
Job_094,1,7100,9082,M0,7185,13,7198,-1884,0,1884
Job_090,2,6876,8860,M0,7198,71,7269,-1591,0,1591
Job_094,2,7100,9082,M2,7198,61,7259,-1823,0,1823
Job_084,3,6461,8189,M5,7207,51,7258,-931,0,931
Job_076,8,5760,7445,M8,7208,44,7252,-193,0,193
Job_077,8,5842,7628,M7,7210,72,7282,-346,0,346
Job_073,9,5443,7256,M4,7223,33,7256,0,0,0
Job_089,5,6871,7715,M9,7245,72,7317,-398,0,398
Job_086,6,6596,8188,M8,7254,19,7273,-915,0,915
Job_085,6,6493,8187,M5,7258,47,7305,-882,0,882
Job_084,4,6461,8189,M2,7259,85,7344,-845,0,845
Job_094,3,7100,9082,M6,7259,7,7266,-1816,0,1816
Job_082,9,6097,7328,M4,7273,55,7328,0,0,0
Job_094,4,7100,9082,M8,7273,64,7337,-1745,0,1745
Job_092,1,6883,8754,M0,7276,85,7361,-1393,0,1393
Job_093,1,7001,8577,M1,7276,78,7354,-1223,0,1223
Job_088,4,6700,8130,M3,7280,69,7349,-781,0,781
Job_079,8,5954,7513,M9,7317,22,7339,-174,0,174
Job_091,5,6882,7875,M4,7328,69,7397,-478,0,478
Job_094,5,7100,9082,M9,7339,76,7415,-1667,0,1667
Job_093,2,7001,8577,M2,7354,9,7363,-1214,0,1214
Job_089,6,6871,7715,M0,7361,47,7408,-307,0,307
Job_092,2,6883,8754,M3,7361,39,7400,-1354,0,1354
Job_088,5,6700,8130,M1,7375,28,7403,-727,0,727
Job_090,3,6876,8860,M4,7397,99,7496,-1364,0,1364
Job_091,6,6882,7875,M8,7397,21,7418,-457,0,457
Job_092,3,6883,8754,M2,7400,74,7474,-1280,0,1280
Job_093,3,7001,8577,M3,7400,36,7436,-1141,0,1141
Job_071,9,5436,7449,M5,7406,43,7449,0,0,0
Job_095,0,7200,8055,M0,7408,29,7437,-618,0,618
Job_080,9,5991,7465,M6,7412,53,7465,0,0,0
Job_091,7,6882,7875,M7,7418,49,7467,-408,0,408
Job_076,9,5760,7445,M9,7424,21,7445,0,0,0
Job_085,7,6493,8187,M3,7436,52,7488,-699,0,699
Job_095,1,7200,8055,M1,7437,78,7515,-540,0,540
Job_096,0,7282,8581,M0,7437,43,7480,-1101,0,1101
Job_086,7,6596,8188,M9,7445,48,7493,-695,0,695
Job_089,7,6871,7715,M6,7465,65,7530,-185,0,185
Job_079,9,5954,7513,M5,7470,43,7513,0,0,0
Job_087,4,6645,8266,M2,7474,85,7559,-707,0,707
Job_092,4,6883,8754,M8,7474,90,7564,-1190,0,1190
Job_084,5,6461,8189,M9,7493,11,7504,-685,0,685
Job_093,4,7001,8577,M4,7496,49,7545,-1032,0,1032
Job_078,8,5903,7793,M9,7504,45,7549,-244,0,244
Job_094,6,7100,9082,M5,7513,47,7560,-1522,0,1522
Job_084,6,6461,8189,M6,7530,40,7570,-619,0,619
Job_101,0,7537,8787,M1,7537,46,7583,-1204,0,1204
Job_087,5,6645,8266,M9,7559,11,7570,-696,0,696
Job_095,2,7200,8055,M2,7559,9,7568,-487,0,487
Job_093,5,7001,8577,M5,7560,11,7571,-1006,0,1006
Job_094,7,7100,9082,M3,7560,52,7612,-1470,0,1470
Job_099,0,7431,8470,M2,7568,14,7582,-888,0,888
Job_084,7,6461,8189,M7,7570,89,7659,-530,0,530
Job_087,6,6645,8266,M6,7570,40,7610,-656,0,656
Job_091,8,6882,7875,M9,7570,72,7642,-233,0,233
Job_092,5,6883,8754,M5,7571,10,7581,-1173,0,1173
Job_096,1,7282,8581,M2,7582,90,7672,-909,0,909
Job_099,1,7431,8470,M0,7582,6,7588,-882,0,882
Job_097,0,7343,9036,M1,7583,91,7674,-1362,0,1362
Job_101,1,7537,8787,M0,7588,37,7625,-1162,0,1162
Job_077,9,5842,7628,M8,7598,30,7628,0,0,0
Job_090,4,6876,8860,M6,7610,9,7619,-1241,0,1241
Job_089,8,6871,7715,M4,7611,6,7617,-98,0,98
Job_095,3,7200,8055,M3,7612,36,7648,-407,0,407
Job_088,6,6700,8130,M6,7619,46,7665,-465,0,465
Job_101,2,7537,8787,M3,7648,61,7709,-1078,0,1078
Job_084,8,6461,8189,M4,7659,26,7685,-504,0,504
Job_092,6,6883,8754,M7,7659,12,7671,-1083,0,1083
Job_088,7,6700,8130,M5,7665,46,7711,-419,0,419
Job_100,0,7499,8913,M2,7672,84,7756,-1157,0,1157
Job_097,1,7343,9036,M0,7674,85,7759,-1277,0,1277
Job_099,2,7431,8470,M1,7674,22,7696,-774,0,774
Job_095,4,7200,8055,M4,7685,49,7734,-321,0,321
Job_089,9,6871,7715,M7,7690,25,7715,0,0,0
Job_098,0,7394,9558,M1,7696,81,7777,-1781,0,1781
Job_093,6,7001,8577,M6,7698,62,7760,-817,0,817
Job_087,7,6645,8266,M7,7715,89,7804,-462,0,462
Job_090,5,6876,8860,M8,7718,52,7770,-1090,0,1090
Job_095,5,7200,8055,M5,7734,11,7745,-310,0,310
Job_099,3,7431,8470,M5,7745,61,7806,-664,0,664
Job_078,9,5903,7793,M4,7756,33,7789,-4,0,4
Job_101,3,7537,8787,M2,7756,13,7769,-1018,0,1018
Job_097,2,7343,9036,M3,7759,39,7798,-1238,0,1238
Job_095,6,7200,8055,M6,7760,62,7822,-233,0,233
Job_102,0,7683,9182,M2,7769,31,7800,-1382,0,1382
Job_100,1,7499,8913,M1,7777,2,7779,-1134,0,1134
Job_094,8,7100,9082,M4,7789,90,7879,-1203,0,1203
Job_097,3,7343,9036,M2,7800,74,7874,-1162,0,1162
Job_102,1,7683,9182,M0,7800,86,7886,-1296,0,1296
Job_090,6,6876,8860,M7,7804,85,7889,-971,0,971
Job_099,4,7431,8470,M3,7806,26,7832,-638,0,638
Job_100,2,7499,8913,M5,7806,52,7858,-1055,0,1055
Job_091,9,6882,7875,M6,7822,53,7875,0,0,0
Job_097,4,7343,9036,M8,7874,90,7964,-1072,0,1072
Job_098,1,7394,9558,M2,7874,95,7969,-1589,0,1589
Job_101,4,7537,8787,M6,7875,32,7907,-880,0,880
Job_087,8,6645,8266,M4,7879,26,7905,-361,0,361
Job_102,2,7683,9182,M1,7886,46,7932,-1250,0,1250
Job_090,7,6876,8860,M3,7889,98,7987,-873,0,873
Job_095,7,7200,8055,M7,7889,56,7945,-110,0,110
Job_103,0,7901,9649,M0,7901,76,7977,-1672,0,1672
Job_085,8,6493,8187,M4,7905,90,7995,-192,0,192
Job_101,5,7537,8787,M5,7907,21,7928,-859,0,859
Job_101,6,7537,8787,M9,7928,32,7960,-827,0,827
Job_102,3,7683,9182,M5,7932,74,8006,-1176,0,1176
Job_104,0,7933,9499,M1,7933,85,8018,-1481,0,1481
Job_088,8,6700,8130,M7,7945,72,8017,-113,0,113
Job_095,8,7200,8055,M8,7964,44,8008,-47,0,47
Job_098,2,7394,9558,M0,7977,71,8048,-1510,0,1510
Job_100,3,7499,8913,M3,7987,95,8082,-831,0,831
Job_099,5,7431,8470,M4,7995,69,8064,-406,0,406
Job_097,5,7343,9036,M5,8006,10,8016,-1020,0,1020
Job_086,8,6596,8188,M7,8017,36,8053,-135,0,135
Job_103,1,7901,9649,M1,8018,69,8087,-1562,0,1562
Job_095,9,7200,8055,M9,8034,21,8055,0,0,0
Job_105,0,8036,9592,M2,8036,31,8067,-1525,0,1525
Job_104,1,7933,9499,M0,8048,13,8061,-1438,0,1438
Job_093,7,7001,8577,M7,8053,56,8109,-468,0,468
Job_096,2,7282,8581,M4,8064,75,8139,-442,0,442
Job_099,6,7431,8470,M8,8064,21,8085,-385,0,385
Job_104,2,7933,9499,M2,8067,61,8128,-1371,0,1371
Job_105,1,8036,9592,M0,8067,86,8153,-1439,0,1439
Job_092,7,6883,8754,M6,8069,89,8158,-596,0,596
Job_088,9,6700,8130,M8,8085,30,8115,-15,0,15
Job_086,9,6596,8188,M3,8109,79,8188,0,0,0
Job_097,6,7343,9036,M7,8109,12,8121,-915,0,915
Job_084,9,6461,8189,M8,8115,74,8189,0,0,0
Job_096,3,7282,8581,M9,8139,11,8150,-431,0,431
Job_102,4,7683,9182,M4,8139,32,8171,-1011,0,1011
Job_085,9,6493,8187,M7,8142,45,8187,0,0,0
Job_105,2,8036,9592,M1,8153,46,8199,-1393,0,1393
Job_107,0,8140,9733,M0,8153,43,8196,-1537,0,1537
Job_092,8,6883,8754,M9,8158,45,8203,-551,0,551
Job_097,7,7343,9036,M6,8158,89,8247,-789,0,789
Job_098,3,7394,9558,M4,8171,99,8270,-1288,0,1288
Job_099,7,7431,8470,M7,8187,49,8236,-234,0,234
Job_096,4,7282,8581,M3,8188,69,8257,-324,0,324
Job_087,9,6645,8266,M8,8192,74,8266,0,0,0
Job_106,0,8085,9815,M0,8196,76,8272,-1543,0,1543
Job_107,1,8140,9733,M2,8196,90,8286,-1447,0,1447
Job_105,3,8036,9592,M5,8199,74,8273,-1319,0,1319
Job_099,8,7431,8470,M9,8236,72,8308,-162,0,162
Job_102,5,7683,9182,M6,8247,88,8335,-847,0,847
Job_096,5,7282,8581,M1,8257,28,8285,-296,0,296
Job_103,2,7901,9649,M3,8257,76,8333,-1316,0,1316
Job_093,8,7001,8577,M8,8266,44,8310,-267,0,267
Job_105,4,8036,9592,M4,8273,32,8305,-1287,0,1287
Job_106,1,8085,9815,M1,8285,69,8354,-1461,0,1461
Job_107,2,8140,9733,M4,8305,75,8380,-1353,0,1353
Job_097,8,7343,9036,M9,8308,45,8353,-683,0,683
Job_101,7,7537,8787,M8,8310,89,8399,-388,0,388
Job_108,0,8311,9601,M2,8311,84,8395,-1206,0,1206
Job_103,3,7901,9649,M5,8333,51,8384,-1265,0,1265
Job_096,6,7282,8581,M6,8335,46,8381,-200,0,200
Job_106,2,8085,9815,M3,8354,76,8430,-1385,0,1385
Job_111,0,8323,10222,M1,8354,91,8445,-1777,0,1777
Job_090,8,6876,8860,M9,8370,22,8392,-468,0,468
Job_104,3,7933,9499,M6,8381,7,8388,-1111,0,1111
Job_096,7,7282,8581,M5,8384,46,8430,-151,0,151
Job_098,4,7394,9558,M6,8388,9,8397,-1161,0,1161
Job_107,3,8140,9733,M9,8392,11,8403,-1330,0,1330
Job_110,0,8322,9362,M2,8395,14,8409,-953,0,953
Job_100,4,7499,8913,M8,8399,48,8447,-466,0,466
Job_101,8,7537,8787,M7,8399,30,8429,-358,0,358
Job_103,4,7901,9649,M2,8409,85,8494,-1155,0,1155
Job_110,1,8322,9362,M0,8409,6,8415,-947,0,947
Job_099,9,7431,8470,M6,8417,53,8470,0,0,0
Job_096,8,7282,8581,M7,8430,72,8502,-79,0,79
Job_106,3,8085,9815,M5,8430,51,8481,-1334,0,1334
Job_107,4,8140,9733,M3,8430,69,8499,-1234,0,1234
Job_112,0,8441,9577,M0,8441,29,8470,-1107,0,1107
Job_109,0,8316,9664,M1,8445,81,8526,-1138,0,1138
Job_100,5,7499,8913,M9,8447,72,8519,-394,0,394
Job_102,6,7683,9182,M8,8447,19,8466,-716,0,716
Job_104,4,7933,9499,M8,8466,64,8530,-969,0,969
Job_105,5,8036,9592,M6,8470,88,8558,-1034,0,1034
Job_111,1,8323,10222,M0,8470,85,8555,-1667,0,1667
Job_106,4,8085,9815,M2,8494,85,8579,-1236,0,1236
Job_103,5,7901,9649,M9,8519,11,8530,-1119,0,1119
Job_112,1,8441,9577,M1,8526,78,8604,-973,0,973
Job_096,9,7282,8581,M8,8551,30,8581,0,0,0
Job_100,6,7499,8913,M0,8555,47,8602,-311,0,311
Job_111,2,8323,10222,M3,8555,39,8594,-1628,0,1628
Job_093,9,7001,8577,M9,8556,21,8577,0,0,0
Job_103,6,7901,9649,M6,8558,40,8598,-1051,0,1051
Job_102,7,7683,9182,M9,8577,48,8625,-557,0,557
Job_109,1,8316,9664,M2,8579,95,8674,-990,0,990
Job_098,5,7394,9558,M8,8581,52,8633,-925,0,925
Job_103,7,7901,9649,M7,8598,89,8687,-962,0,962
Job_100,7,7499,8913,M6,8602,65,8667,-246,0,246
Job_110,2,8322,9362,M1,8604,22,8626,-736,0,736
Job_104,5,7933,9499,M9,8625,76,8701,-798,0,798
Job_108,1,8311,9601,M1,8626,2,8628,-973,0,973
Job_110,3,8322,9362,M5,8626,61,8687,-675,0,675
Job_113,0,8540,9831,M1,8628,85,8713,-1118,0,1118
Job_105,6,8036,9592,M8,8633,19,8652,-940,0,940
Job_114,0,8640,9866,M0,8640,29,8669,-1197,0,1197
Job_100,8,7499,8913,M4,8667,6,8673,-240,0,240
Job_109,2,8316,9664,M0,8674,71,8745,-919,0,919
Job_112,2,8441,9577,M2,8674,9,8683,-894,0,894
Job_112,3,8441,9577,M3,8683,36,8719,-858,0,858
Job_102,8,7683,9182,M7,8687,36,8723,-459,0,459
Job_108,2,8311,9601,M5,8687,52,8739,-862,0,862
Job_092,9,6883,8754,M4,8699,33,8732,-22,0,22
Job_111,3,8323,10222,M2,8700,74,8774,-1448,0,1448
Job_105,7,8036,9592,M9,8701,48,8749,-843,0,843
Job_107,5,8140,9733,M1,8713,28,8741,-992,0,992
Job_110,4,8322,9362,M3,8719,26,8745,-617,0,617
Job_098,6,7394,9558,M7,8723,85,8808,-750,0,750
Job_101,9,7537,8787,M4,8732,55,8787,0,0,0
Job_104,6,7933,9499,M5,8739,47,8786,-713,0,713
Job_107,6,8140,9733,M6,8741,46,8787,-946,0,946
Job_114,1,8640,9866,M1,8741,78,8819,-1047,0,1047
Job_108,3,8311,9601,M3,8745,95,8840,-761,0,761
Job_113,1,8540,9831,M0,8745,13,8758,-1073,0,1073
Job_106,5,8085,9815,M9,8749,11,8760,-1055,0,1055
Job_115,0,8722,10449,M0,8758,43,8801,-1648,0,1648
Job_111,4,8323,10222,M8,8774,90,8864,-1358,0,1358
Job_113,2,8540,9831,M2,8774,61,8835,-996,0,996
Job_106,6,8085,9815,M6,8787,40,8827,-988,0,988
Job_110,5,8322,9362,M4,8787,69,8856,-506,0,506
Job_105,8,8036,9592,M7,8808,36,8844,-748,0,748
Job_090,9,6876,8860,M5,8817,43,8860,0,0,0
Job_116,0,8783,10053,M1,8819,91,8910,-1143,0,1143
Job_113,3,8540,9831,M6,8835,7,8842,-989,0,989
Job_114,2,8640,9866,M2,8835,9,8844,-1022,0,1022
Job_104,7,7933,9499,M3,8840,52,8892,-607,0,607
Job_115,1,8722,10449,M2,8844,90,8934,-1515,0,1515
Job_109,3,8316,9664,M4,8856,99,8955,-709,0,709
Job_107,7,8140,9733,M5,8860,46,8906,-827,0,827
Job_110,6,8322,9362,M8,8864,21,8885,-477,0,477
Job_108,4,8311,9601,M8,8885,48,8933,-668,0,668
Job_100,9,7499,8913,M7,8888,25,8913,0,0,0
Job_098,7,7394,9558,M3,8892,98,8990,-568,0,568
Job_111,5,8323,10222,M5,8906,10,8916,-1306,0,1306
Job_116,1,8783,10053,M0,8910,85,8995,-1058,0,1058
Job_117,0,8834,10394,M1,8910,81,8991,-1403,0,1403
Job_110,7,8322,9362,M7,8913,49,8962,-400,0,400
Job_108,5,8311,9601,M9,8933,72,9005,-596,0,596
Job_113,4,8540,9831,M8,8933,64,8997,-834,0,834
Job_118,0,8871,9770,M2,8934,14,8948,-822,0,822
Job_119,0,8939,10132,M2,8948,84,9032,-1100,0,1100
Job_103,8,7901,9649,M4,8955,26,8981,-668,0,668
Job_109,4,8316,9664,M6,8955,9,8964,-700,0,700
Job_107,8,8140,9733,M7,8962,72,9034,-699,0,699
Job_114,3,8640,9866,M3,8990,36,9026,-840,0,840
Job_120,0,8977,10661,M1,8991,46,9037,-1624,0,1624
Job_118,1,8871,9770,M0,8995,6,9001,-769,0,769
Job_109,5,8316,9664,M8,8997,52,9049,-615,0,615
Job_097,9,7343,9036,M4,9003,33,9036,0,0,0
Job_108,6,8311,9601,M0,9005,47,9052,-549,0,549
Job_110,8,8322,9362,M9,9005,72,9077,-285,0,285
Job_116,2,8783,10053,M3,9026,39,9065,-988,0,988
Job_112,4,8441,9577,M4,9036,49,9085,-492,0,492
Job_094,9,7100,9082,M7,9037,45,9082,0,0,0
Job_118,2,8871,9770,M1,9037,22,9059,-711,0,711
Job_108,7,8311,9601,M6,9052,65,9117,-484,0,484
Job_120,1,8977,10661,M0,9052,37,9089,-1572,0,1572
Job_119,1,8939,10132,M1,9059,2,9061,-1071,0,1071
Job_113,5,8540,9831,M9,9077,76,9153,-678,0,678
Job_109,6,8316,9664,M7,9082,85,9167,-497,0,497
Job_104,8,7933,9499,M4,9085,90,9175,-324,0,324
Job_112,5,8441,9577,M5,9085,11,9096,-481,0,481
Job_119,2,8939,10132,M5,9096,52,9148,-984,0,984
Job_102,9,7683,9182,M3,9103,79,9182,0,0,0
Job_112,6,8441,9577,M6,9117,62,9179,-398,0,398
Job_121,0,9123,10454,M2,9123,31,9154,-1300,0,1300
Job_098,8,7394,9558,M9,9153,22,9175,-383,0,383
Job_113,6,8540,9831,M5,9153,47,9200,-631,0,631
Job_116,3,8783,10053,M2,9154,74,9228,-825,0,825
Job_121,1,9123,10454,M0,9154,86,9240,-1214,0,1214
Job_106,7,8085,9815,M7,9167,89,9256,-559,0,559
Job_108,8,8311,9601,M4,9175,6,9181,-420,0,420
Job_114,4,8640,9866,M4,9181,49,9230,-636,0,636
Job_109,7,8316,9664,M3,9182,98,9280,-384,0,384
Job_118,3,8871,9770,M5,9200,61,9261,-509,0,509
Job_117,1,8834,10394,M2,9228,95,9323,-1071,0,1071
Job_121,2,9123,10454,M1,9240,46,9286,-1168,0,1168
Job_106,8,8085,9815,M4,9256,26,9282,-533,0,533
Job_112,7,8441,9577,M7,9256,56,9312,-265,0,265
Job_114,5,8640,9866,M5,9261,11,9272,-594,0,594
Job_109,8,8316,9664,M9,9280,22,9302,-362,0,362
Job_113,7,8540,9831,M3,9280,52,9332,-499,0,499
Job_121,3,9123,10454,M5,9286,74,9360,-1094,0,1094
Job_110,9,8322,9362,M6,9309,53,9362,0,0,0
Job_111,6,8323,10222,M7,9312,12,9324,-898,0,898
Job_112,8,8441,9577,M8,9312,44,9356,-221,0,221
Job_113,8,8540,9831,M4,9332,90,9422,-409,0,409
Job_118,4,8871,9770,M3,9332,26,9358,-412,0,412
Job_122,0,9341,11333,M0,9341,76,9417,-1916,0,1916
Job_116,4,8783,10053,M8,9356,90,9446,-607,0,607
Job_119,3,8939,10132,M3,9358,95,9453,-679,0,679
Job_111,7,8323,10222,M6,9362,89,9451,-771,0,771
Job_123,0,9373,11165,M1,9373,85,9458,-1707,0,1707
Job_118,5,8871,9770,M4,9422,69,9491,-279,0,279
Job_116,5,8783,10053,M5,9446,10,9456,-597,0,597
Job_111,8,8323,10222,M9,9451,45,9496,-726,0,726
Job_114,6,8640,9866,M6,9451,62,9513,-353,0,353
Job_119,4,8939,10132,M8,9453,48,9501,-631,0,631
Job_104,9,7933,9499,M7,9454,45,9499,0,0,0
Job_122,1,9341,11333,M1,9458,69,9527,-1806,0,1806
Job_123,1,9373,11165,M0,9458,13,9471,-1694,0,1694
Job_117,2,8834,10394,M0,9471,71,9542,-852,0,852
Job_123,2,9373,11165,M2,9471,61,9532,-1633,0,1633
Job_115,2,8722,10449,M4,9491,75,9566,-883,0,883
Job_116,6,8783,10053,M7,9499,12,9511,-542,0,542
Job_118,6,8871,9770,M8,9501,21,9522,-248,0,248
Job_105,9,8036,9592,M3,9513,79,9592,0,0,0
Job_116,7,8783,10053,M6,9513,89,9602,-451,0,451
Job_098,9,7394,9558,M5,9515,43,9558,0,0,0
Job_118,7,8871,9770,M7,9522,49,9571,-199,0,199
Job_124,0,9476,11255,M2,9532,31,9563,-1692,0,1692
Job_112,9,8441,9577,M9,9556,21,9577,0,0,0
Job_117,3,8834,10394,M4,9566,99,9665,-729,0,729
Job_103,9,7901,9649,M8,9575,74,9649,0,0,0
Job_108,9,8311,9601,M7,9576,25,9601,0,0,0
Job_118,8,8871,9770,M9,9577,72,9649,-121,0,121
Job_126,0,9580,10908,M0,9580,43,9623,-1285,0,1285
Job_120,2,8977,10661,M3,9592,61,9653,-1008,0,1008
Job_114,7,8640,9866,M7,9601,56,9657,-209,0,209
Job_123,3,9373,11165,M6,9602,7,9609,-1556,0,1556
Job_109,9,8316,9664,M5,9621,43,9664,0,0,0
Job_124,1,9476,11255,M0,9623,86,9709,-1546,0,1546
Job_126,1,9580,10908,M2,9623,90,9713,-1195,0,1195
Job_119,5,8939,10132,M9,9649,72,9721,-411,0,411
Job_122,2,9341,11333,M3,9653,76,9729,-1604,0,1604
Job_114,8,8640,9866,M8,9657,44,9701,-165,0,165
Job_117,4,8834,10394,M6,9665,9,9674,-720,0,720
Job_121,4,9123,10454,M4,9665,32,9697,-757,0,757
Job_107,9,8140,9733,M8,9703,30,9733,0,0,0
Job_124,2,9476,11255,M1,9709,46,9755,-1500,0,1500
Job_125,0,9525,11380,M0,9709,76,9785,-1595,0,1595
Job_120,3,8977,10661,M2,9713,13,9726,-935,0,935
Job_126,2,9580,10908,M4,9713,75,9788,-1120,0,1120
Job_118,9,8871,9770,M6,9717,53,9770,0,0,0
Job_116,8,8783,10053,M9,9721,45,9766,-287,0,287
Job_122,3,9341,11333,M5,9729,51,9780,-1553,0,1553
Job_106,9,8085,9815,M8,9741,74,9815,0,0,0
Job_127,0,9751,11097,M2,9751,84,9835,-1262,0,1262
Job_128,0,9756,11417,M1,9756,81,9837,-1580,0,1580
Job_115,3,8722,10449,M9,9766,11,9777,-672,0,672
Job_121,5,9123,10454,M6,9770,88,9858,-596,0,596
Job_115,4,8722,10449,M3,9777,69,9846,-603,0,603
Job_124,3,9476,11255,M5,9780,74,9854,-1401,0,1401
Job_119,6,8939,10132,M0,9785,47,9832,-300,0,300
Job_113,9,8540,9831,M7,9786,45,9831,0,0,0
Job_126,3,9580,10908,M9,9788,11,9799,-1109,0,1109
Job_117,5,8834,10394,M8,9815,52,9867,-527,0,527
Job_129,0,9762,10702,M2,9835,14,9849,-853,0,853
Job_130,0,9763,11184,M1,9837,91,9928,-1256,0,1256
Job_114,9,8640,9866,M9,9845,21,9866,0,0,0
Job_126,4,9580,10908,M3,9846,69,9915,-993,0,993
Job_128,1,9756,11417,M2,9849,95,9944,-1473,0,1473
Job_129,1,9762,10702,M0,9849,6,9855,-847,0,847
Job_124,4,9476,11255,M4,9854,32,9886,-1369,0,1369
Job_119,7,8939,10132,M6,9858,65,9923,-209,0,209
Job_117,6,8834,10394,M7,9867,85,9952,-442,0,442
Job_121,6,9123,10454,M8,9867,19,9886,-568,0,568
Job_131,0,9881,11051,M0,9881,29,9910,-1141,0,1141
Job_121,7,9123,10454,M9,9886,48,9934,-520,0,520
Job_123,4,9373,11165,M8,9886,64,9950,-1215,0,1215
Job_119,8,8939,10132,M4,9923,6,9929,-203,0,203
Job_120,4,8977,10661,M6,9923,32,9955,-706,0,706
Job_115,5,8722,10449,M1,9928,28,9956,-493,0,493
Job_130,1,9763,11184,M0,9928,85,10013,-1171,0,1171
Job_122,4,9341,11333,M2,9944,85,10029,-1304,0,1304
Job_123,5,9373,11165,M9,9950,76,10026,-1139,0,1139
Job_117,7,8834,10394,M3,9952,98,10050,-344,0,344
Job_121,8,9123,10454,M7,9952,36,9988,-466,0,466
Job_120,5,8977,10661,M5,9955,21,9976,-685,0,685
Job_124,5,9476,11255,M6,9955,88,10043,-1212,0,1212
Job_129,2,9762,10702,M1,9956,22,9978,-724,0,724
Job_127,1,9751,11097,M1,9978,2,9980,-1117,0,1117
Job_129,3,9762,10702,M5,9978,61,10039,-663,0,663
Job_132,0,9980,11430,M1,9980,85,10065,-1365,0,1365
Job_116,9,8783,10053,M4,10020,33,10053,0,0,0
Job_120,6,8977,10661,M9,10026,32,10058,-603,0,603
Job_127,2,9751,11097,M5,10039,52,10091,-1006,0,1006
Job_115,6,8722,10449,M6,10043,46,10089,-360,0,360
Job_124,6,9476,11255,M8,10043,19,10062,-1193,0,1193
Job_129,4,9762,10702,M3,10050,26,10076,-626,0,626
Job_117,8,8834,10394,M9,10058,22,10080,-314,0,314
Job_131,1,9881,11051,M1,10065,78,10143,-908,0,908
Job_132,1,9980,11430,M0,10065,13,10078,-1352,0,1352
Job_129,5,9762,10702,M4,10076,69,10145,-557,0,557
Job_130,2,9763,11184,M3,10076,39,10115,-1069,0,1069
Job_128,2,9756,11417,M0,10078,71,10149,-1268,0,1268
Job_132,2,9980,11430,M2,10078,61,10139,-1291,0,1291
Job_122,5,9341,11333,M9,10080,11,10091,-1242,0,1242
Job_115,7,8722,10449,M5,10091,46,10137,-312,0,312
Job_122,6,9341,11333,M6,10091,40,10131,-1202,0,1202
Job_124,7,9476,11255,M9,10091,48,10139,-1116,0,1116
Job_119,9,8939,10132,M7,10107,25,10132,0,0,0
Job_127,3,9751,11097,M3,10115,95,10210,-887,0,887
Job_122,7,9341,11333,M7,10132,89,10221,-1112,0,1112
Job_123,6,9373,11165,M5,10137,47,10184,-981,0,981
Job_130,3,9763,11184,M2,10139,74,10213,-971,0,971
Job_132,3,9980,11430,M6,10139,7,10146,-1284,0,1284
Job_126,5,9580,10908,M1,10143,28,10171,-737,0,737
Job_132,4,9980,11430,M8,10146,64,10210,-1220,0,1220
Job_125,1,9525,11380,M1,10171,69,10240,-1140,0,1140
Job_126,6,9580,10908,M6,10171,46,10217,-691,0,691
Job_111,9,8323,10222,M4,10189,33,10222,0,0,0
Job_120,7,8977,10661,M8,10210,89,10299,-362,0,362
Job_123,7,9373,11165,M3,10210,52,10262,-903,0,903
Job_132,5,9980,11430,M9,10210,76,10286,-1144,0,1144
Job_131,2,9881,11051,M2,10213,9,10222,-829,0,829
Job_126,7,9580,10908,M5,10217,46,10263,-645,0,645
Job_115,8,8722,10449,M7,10221,72,10293,-156,0,156
Job_128,3,9756,11417,M4,10222,99,10321,-1096,0,1096
Job_131,3,9881,11051,M3,10262,36,10298,-753,0,753
Job_132,6,9980,11430,M5,10286,47,10333,-1097,0,1097
Job_126,8,9580,10908,M7,10293,72,10365,-543,0,543
Job_125,2,9525,11380,M3,10298,76,10374,-1006,0,1006
Job_129,6,9762,10702,M8,10299,21,10320,-382,0,382
Job_130,4,9763,11184,M8,10320,90,10410,-774,0,774
Job_128,4,9756,11417,M6,10321,9,10330,-1087,0,1087
Job_131,4,9881,11051,M4,10321,49,10370,-681,0,681
Job_117,9,8834,10394,M5,10351,43,10394,0,0,0
Job_129,7,9762,10702,M7,10365,49,10414,-288,0,288
Job_123,8,9373,11165,M4,10370,90,10460,-705,0,705
Job_121,9,9123,10454,M3,10375,79,10454,0,0,0
Job_131,5,9881,11051,M5,10394,11,10405,-646,0,646
Job_125,3,9525,11380,M5,10405,51,10456,-924,0,924
Job_131,6,9881,11051,M6,10405,62,10467,-584,0,584
Job_120,8,8977,10661,M7,10414,30,10444,-217,0,217
Job_129,8,9762,10702,M9,10414,72,10486,-216,0,216
Job_115,9,8722,10449,M8,10419,30,10449,0,0,0
Job_124,8,9476,11255,M7,10444,36,10480,-775,0,775
Job_127,4,9751,11097,M8,10449,48,10497,-600,0,600
Job_132,7,9980,11430,M3,10454,52,10506,-924,0,924
Job_125,4,9525,11380,M2,10456,85,10541,-839,0,839
Job_130,5,9763,11184,M5,10456,10,10466,-718,0,718
Job_122,8,9341,11333,M4,10460,26,10486,-847,0,847
Job_131,7,9881,11051,M7,10480,56,10536,-515,0,515
Job_127,5,9751,11097,M9,10497,72,10569,-528,0,528
Job_128,5,9756,11417,M8,10497,52,10549,-868,0,868
Job_132,8,9980,11430,M4,10506,90,10596,-834,0,834
Job_130,6,9763,11184,M7,10536,12,10548,-636,0,636
Job_130,7,9763,11184,M6,10548,89,10637,-547,0,547
Job_128,6,9756,11417,M7,10549,85,10634,-783,0,783
Job_131,8,9881,11051,M8,10549,44,10593,-458,0,458
Job_125,5,9525,11380,M9,10569,11,10580,-800,0,800
Job_127,6,9751,11097,M0,10569,47,10616,-481,0,481
Job_120,9,8977,10661,M4,10606,55,10661,0,0,0
Job_128,7,9756,11417,M3,10634,98,10732,-685,0,685
Job_130,8,9763,11184,M9,10637,45,10682,-502,0,502
Job_129,9,9762,10702,M6,10649,53,10702,0,0,0
Job_127,7,9751,11097,M6,10702,65,10767,-330,0,330
Job_128,8,9756,11417,M9,10732,22,10754,-663,0,663
Job_125,6,9525,11380,M6,10767,40,10807,-573,0,573
Job_127,8,9751,11097,M4,10767,6,10773,-324,0,324
Job_125,7,9525,11380,M7,10807,89,10896,-484,0,484
Job_126,9,9580,10908,M8,10878,30,10908,0,0,0
Job_125,8,9525,11380,M4,10896,26,10922,-458,0,458
Job_131,9,9881,11051,M9,11030,21,11051,0,0,0
Job_127,9,9751,11097,M7,11072,25,11097,0,0,0
Job_123,9,9373,11165,M7,11120,45,11165,0,0,0
Job_130,9,9763,11184,M4,11151,33,11184,0,0,0
Job_124,9,9476,11255,M3,11176,79,11255,0,0,0
Job_122,9,9341,11333,M8,11232,74,11306,-27,0,27
Job_125,9,9525,11380,M8,11306,74,11380,0,0,0
Job_128,9,9756,11417,M5,11374,43,11417,0,0,0
Job_132,9,9980,11430,M7,11385,45,11430,0,0,0
