Job,Operation,Arrival,Deadline,Machine,Start,Processing Time,End,Lateness,Tardiness,Earliness
Job_042,9,3106,4345,M6,4336,53,4389,44,44,0
Job_030,9,2307,4188,M8,4339,74,4413,225,225,0
Job_044,8,3210,4521,M7,4339,30,4369,-152,0,152
Job_047,6,3598,5299,M5,4341,47,4388,-911,0,911
Job_057,0,4320,5564,M0,4348,29,4377,-1187,0,1187
Job_046,5,3567,5447,M9,4349,11,4360,-1087,0,1087
Job_045,8,3353,5051,M7,4369,36,4405,-646,0,646
Job_046,6,3567,5447,M6,4389,40,4429,-1018,0,1018
Job_058,0,4400,6007,M0,4400,43,4443,-1564,0,1564
Job_050,5,3801,5408,M1,4405,28,4433,-975,0,975
Job_055,2,4096,5340,M2,4405,9,4414,-926,0,926
Job_037,9,2752,4454,M7,4409,45,4454,0,0,0
Job_048,6,3699,5397,M8,4413,19,4432,-965,0,965
Job_041,8,3071,5134,M9,4415,22,4437,-697,0,697
Job_055,3,4096,5340,M3,4415,36,4451,-889,0,889
Job_050,6,3801,5408,M6,4433,46,4479,-929,0,929
Job_056,0,4192,5894,M1,4433,85,4518,-1376,0,1376
Job_048,7,3699,5397,M9,4437,48,4485,-912,0,912
Job_052,2,3973,6037,M0,4443,71,4514,-1523,0,1523
Job_058,1,4400,6007,M2,4443,90,4533,-1474,0,1474
Job_051,3,3968,5531,M3,4451,95,4546,-985,0,985
Job_046,7,3567,5447,M7,4454,89,4543,-904,0,904
Job_044,9,3210,4521,M4,4466,55,4521,0,0,0
Job_050,7,3801,5408,M5,4479,46,4525,-883,0,883
Job_056,1,4192,5894,M0,4518,13,4531,-1363,0,1363
Job_059,0,4460,6249,M1,4518,91,4609,-1640,0,1640
Job_055,4,4096,5340,M4,4521,49,4570,-770,0,770
Job_056,2,4192,5894,M2,4533,61,4594,-1300,0,1300
Job_039,9,2960,4567,M8,4537,30,4567,0,0,0
Job_048,8,3699,5397,M7,4543,36,4579,-818,0,818
Job_047,7,3598,5299,M3,4546,52,4598,-701,0,701
Job_033,9,2533,4597,M5,4554,43,4597,0,0,0
Job_051,4,3968,5531,M8,4567,48,4615,-916,0,916
Job_046,8,3567,5447,M4,4570,26,4596,-851,0,851
Job_050,8,3801,5408,M7,4579,72,4651,-757,0,757
Job_056,3,4192,5894,M6,4594,7,4601,-1293,0,1293
Job_061,0,4546,5785,M2,4594,14,4608,-1177,0,1177
Job_055,5,4096,5340,M5,4597,11,4608,-732,0,732
Job_047,8,3598,5299,M4,4598,90,4688,-611,0,611
Job_049,2,3747,5628,M3,4598,76,4674,-954,0,954
Job_055,6,4096,5340,M6,4608,62,4670,-670,0,670
Job_061,1,4546,5785,M0,4608,6,4614,-1171,0,1171
Job_057,1,4320,5564,M1,4609,78,4687,-877,0,877
Job_062,0,4613,6176,M2,4613,84,4697,-1479,0,1479
Job_059,1,4460,6249,M0,4614,85,4699,-1550,0,1550
Job_051,5,3968,5531,M9,4615,72,4687,-844,0,844
Job_056,4,4192,5894,M8,4615,64,4679,-1215,0,1215
Job_049,3,3747,5628,M5,4674,51,4725,-903,0,903
Job_054,2,3980,5770,M3,4674,39,4713,-1057,0,1057
Job_056,5,4192,5894,M9,4687,76,4763,-1131,0,1131
Job_061,2,4546,5785,M1,4687,22,4709,-1076,0,1076
Job_058,2,4400,6007,M4,4688,75,4763,-1244,0,1244
Job_057,2,4320,5564,M2,4697,9,4706,-858,0,858
Job_051,6,3968,5531,M0,4699,47,4746,-785,0,785
Job_063,0,4650,5961,M1,4709,46,4755,-1206,0,1206
Job_043,9,3173,4736,M7,4711,25,4736,0,0,0
Job_057,3,4320,5564,M3,4713,36,4749,-815,0,815
Job_049,4,3747,5628,M2,4725,85,4810,-818,0,818
Job_061,3,4546,5785,M5,4725,61,4786,-999,0,999
Job_055,7,4096,5340,M7,4736,56,4792,-548,0,548
Job_051,7,3968,5531,M6,4746,65,4811,-720,0,720
Job_059,2,4460,6249,M3,4749,39,4788,-1461,0,1461
Job_062,1,4613,6176,M1,4755,2,4757,-1419,0,1419
Job_063,1,4650,5961,M0,4755,37,4792,-1169,0,1169
Job_060,0,4511,6574,M1,4757,81,4838,-1736,0,1736
Job_058,3,4400,6007,M9,4763,11,4774,-1233,0,1233
Job_040,9,3020,4809,M4,4776,33,4809,0,0,0
Job_062,2,4613,6176,M5,4786,52,4838,-1338,0,1338
Job_061,4,4546,5785,M3,4788,26,4814,-971,0,971
Job_055,8,4096,5340,M8,4792,44,4836,-504,0,504
Job_057,4,4320,5564,M4,4809,49,4858,-706,0,706
Job_049,5,3747,5628,M9,4810,11,4821,-807,0,807
Job_054,3,3980,5770,M2,4810,74,4884,-886,0,886
Job_063,2,4650,5961,M3,4814,61,4875,-1086,0,1086
Job_049,6,3747,5628,M6,4821,40,4861,-767,0,767
Job_057,5,4320,5564,M5,4858,11,4869,-695,0,695
Job_061,5,4546,5785,M4,4858,69,4927,-858,0,858
Job_049,7,3747,5628,M7,4861,89,4950,-678,0,678
Job_056,6,4192,5894,M5,4869,47,4916,-978,0,978
Job_057,6,4320,5564,M6,4869,62,4931,-633,0,633
Job_053,4,3979,5218,M3,4875,26,4901,-317,0,317
Job_054,4,3980,5770,M8,4884,90,4974,-796,0,796
Job_059,3,4460,6249,M2,4884,74,4958,-1291,0,1291
Job_058,4,4400,6007,M3,4901,69,4970,-1037,0,1037
Job_053,5,3979,5218,M4,4927,69,4996,-222,0,222
Job_057,7,4320,5564,M7,4950,56,5006,-558,0,558
Job_063,3,4650,5961,M2,4958,13,4971,-990,0,990
Job_058,5,4400,6007,M1,4970,28,4998,-1009,0,1009
Job_060,1,4511,6574,M2,4971,95,5066,-1508,0,1508
Job_063,4,4650,5961,M6,4971,32,5003,-958,0,958
Job_045,9,3353,5051,M3,4972,79,5051,0,0,0
Job_054,5,3980,5770,M5,4974,10,4984,-786,0,786
Job_061,6,4546,5785,M8,4974,21,4995,-790,0,790
Job_049,8,3747,5628,M4,4996,26,5022,-606,0,606
Job_053,6,3979,5218,M8,4996,21,5017,-201,0,201
Job_058,6,4400,6007,M6,5003,46,5049,-958,0,958
Job_063,5,4650,5961,M5,5003,21,5024,-937,0,937
Job_054,6,3980,5770,M7,5006,12,5018,-752,0,752
Job_065,0,5007,6887,M0,5007,76,5083,-1804,0,1804
Job_059,4,4460,6249,M8,5017,90,5107,-1142,0,1142
Job_053,7,3979,5218,M7,5018,49,5067,-151,0,151
Job_051,8,3968,5531,M4,5022,6,5028,-503,0,503
Job_063,6,4650,5961,M9,5024,32,5056,-905,0,905
Job_052,3,3973,6037,M4,5028,99,5127,-910,0,910
Job_066,0,5038,6739,M1,5038,85,5123,-1616,0,1616
Job_054,7,3980,5770,M6,5049,89,5138,-632,0,632
Job_056,7,4192,5894,M3,5051,52,5103,-791,0,791
Job_064,0,4793,6491,M2,5066,31,5097,-1394,0,1394
Job_053,8,3979,5218,M9,5067,72,5139,-79,0,79
Job_061,7,4546,5785,M7,5067,49,5116,-669,0,669
Job_060,2,4511,6574,M0,5083,71,5154,-1420,0,1420
Job_041,9,3071,5134,M5,5091,43,5134,0,0,0
Job_062,3,4613,6176,M3,5103,95,5198,-978,0,978
Job_057,8,4320,5564,M8,5107,44,5151,-413,0,413
Job_065,1,5007,6887,M1,5123,69,5192,-1695,0,1695
Job_059,5,4460,6249,M5,5134,10,5144,-1105,0,1105
Job_052,4,3973,6037,M6,5138,9,5147,-890,0,890
Job_054,8,3980,5770,M9,5139,45,5184,-586,0,586
Job_067,0,5139,6837,M2,5139,31,5170,-1667,0,1667
Job_058,7,4400,6007,M5,5144,46,5190,-817,0,817
Job_059,6,4460,6249,M7,5144,12,5156,-1093,0,1093
Job_063,7,4650,5961,M8,5151,89,5240,-721,0,721
Job_060,3,4511,6574,M4,5154,99,5253,-1321,0,1321
Job_064,1,4793,6491,M0,5154,86,5240,-1251,0,1251
Job_053,9,3979,5218,M6,5165,53,5218,0,0,0
Job_061,8,4546,5785,M9,5184,72,5256,-529,0,529
Job_065,2,5007,6887,M3,5198,76,5274,-1613,0,1613
Job_062,4,4613,6176,M8,5240,48,5288,-888,0,888
Job_064,2,4793,6491,M1,5240,46,5286,-1205,0,1205
Job_069,0,5241,6848,M0,5241,43,5284,-1564,0,1564
Job_056,8,4192,5894,M4,5253,90,5343,-551,0,551
Job_060,4,4511,6574,M6,5253,9,5262,-1312,0,1312
Job_047,9,3598,5299,M7,5254,45,5299,0,0,0
Job_059,7,4460,6249,M6,5262,89,5351,-898,0,898
Job_065,3,5007,6887,M5,5274,51,5325,-1562,0,1562
Job_066,1,5038,6739,M0,5284,13,5297,-1442,0,1442
Job_069,1,5241,6848,M2,5284,90,5374,-1474,0,1474
Job_060,5,4511,6574,M8,5288,52,5340,-1234,0,1234
Job_067,1,5139,6837,M0,5297,86,5383,-1454,0,1454
Job_063,8,4650,5961,M7,5299,30,5329,-632,0,632
Job_048,9,3699,5397,M3,5318,79,5397,0,0,0
Job_055,9,4096,5340,M9,5319,21,5340,0,0,0
Job_064,3,4793,6491,M5,5325,74,5399,-1092,0,1092
Job_060,6,4511,6574,M7,5340,85,5425,-1149,0,1149
Job_062,5,4613,6176,M9,5340,72,5412,-764,0,764
Job_050,9,3801,5408,M8,5343,30,5373,-35,0,35
Job_046,9,3567,5447,M8,5373,74,5447,0,0,0
Job_066,2,5038,6739,M2,5374,61,5435,-1304,0,1304
Job_069,2,5241,6848,M4,5374,75,5449,-1399,0,1399
Job_067,2,5139,6837,M1,5383,46,5429,-1408,0,1408
Job_068,0,5187,7068,M0,5383,76,5459,-1609,0,1609
Job_059,8,4460,6249,M9,5412,45,5457,-792,0,792
Job_058,8,4400,6007,M7,5425,72,5497,-510,0,510
Job_060,7,4511,6574,M3,5425,98,5523,-1051,0,1051
Job_067,3,5139,6837,M5,5429,74,5503,-1334,0,1334
Job_073,0,5420,7210,M1,5429,91,5520,-1690,0,1690
Job_066,3,5038,6739,M6,5435,7,5442,-1297,0,1297
Job_072,0,5419,6658,M2,5435,14,5449,-1209,0,1209
Job_066,4,5038,6739,M8,5447,64,5511,-1228,0,1228
Job_064,4,4793,6491,M4,5449,32,5481,-1010,0,1010
Job_070,0,5408,6971,M2,5449,84,5533,-1438,0,1438
Job_069,3,5241,6848,M9,5457,11,5468,-1380,0,1380
Job_062,6,4613,6176,M0,5459,47,5506,-670,0,670
Job_064,5,4793,6491,M6,5481,88,5569,-922,0,922
Job_067,4,5139,6837,M4,5503,32,5535,-1302,0,1302
Job_051,9,3968,5531,M7,5506,25,5531,0,0,0
Job_072,1,5419,6658,M0,5506,6,5512,-1146,0,1146
Job_072,2,5419,6658,M1,5520,22,5542,-1116,0,1116
Job_073,1,5420,7210,M0,5520,85,5605,-1605,0,1605
Job_069,4,5241,6848,M3,5523,69,5592,-1256,0,1256
Job_065,4,5007,6887,M2,5533,85,5618,-1269,0,1269
Job_070,1,5408,6971,M1,5542,2,5544,-1427,0,1427
Job_072,3,5419,6658,M5,5542,61,5603,-1055,0,1055
Job_057,9,4320,5564,M9,5543,21,5564,0,0,0
Job_068,1,5187,7068,M1,5544,69,5613,-1455,0,1455
Job_049,9,3747,5628,M8,5554,74,5628,0,0,0
Job_066,5,5038,6739,M9,5564,76,5640,-1099,0,1099
Job_062,7,4613,6176,M6,5569,65,5634,-542,0,542
Job_070,2,5408,6971,M5,5603,52,5655,-1316,0,1316
Job_072,4,5419,6658,M3,5603,26,5629,-1029,0,1029
Job_074,0,5536,6780,M0,5605,29,5634,-1146,0,1146
Job_069,5,5241,6848,M1,5613,28,5641,-1207,0,1207
Job_064,6,4793,6491,M8,5628,19,5647,-844,0,844
Job_062,8,4613,6176,M4,5634,6,5640,-536,0,536
Job_067,5,5139,6837,M6,5634,88,5722,-1115,0,1115
Job_065,5,5007,6887,M9,5640,11,5651,-1236,0,1236
Job_072,5,5419,6658,M4,5640,69,5709,-949,0,949
Job_074,1,5536,6780,M1,5641,78,5719,-1061,0,1061
Job_052,5,3973,6037,M8,5647,52,5699,-338,0,338
Job_064,7,4793,6491,M9,5651,48,5699,-792,0,792
Job_066,6,5038,6739,M5,5655,47,5702,-1037,0,1037
Job_070,3,5408,6971,M3,5655,95,5750,-1221,0,1221
Job_060,8,4511,6574,M9,5699,22,5721,-853,0,853
Job_064,8,4793,6491,M7,5699,36,5735,-756,0,756
Job_072,6,5419,6658,M8,5709,21,5730,-928,0,928
Job_074,2,5536,6780,M2,5719,9,5728,-1052,0,1052
Job_075,0,5632,7334,M1,5719,85,5804,-1530,0,1530
Job_067,6,5139,6837,M8,5730,19,5749,-1088,0,1088
Job_061,9,4546,5785,M6,5732,53,5785,0,0,0
Job_052,6,3973,6037,M7,5735,85,5820,-217,0,217
Job_054,9,3980,5770,M4,5737,33,5770,0,0,0
Job_067,7,5139,6837,M9,5749,48,5797,-1040,0,1040
Job_070,4,5408,6971,M8,5750,48,5798,-1173,0,1173
Job_074,3,5536,6780,M3,5750,36,5786,-994,0,994
Job_076,0,5760,7004,M0,5760,29,5789,-1215,0,1215
Job_069,6,5241,6848,M6,5785,46,5831,-1017,0,1017
Job_066,7,5038,6739,M3,5786,52,5838,-901,0,901
Job_074,4,5536,6780,M4,5786,49,5835,-945,0,945
Job_070,5,5408,6971,M9,5798,72,5870,-1101,0,1101
Job_075,1,5632,7334,M0,5804,13,5817,-1517,0,1517
Job_076,1,5760,7004,M1,5804,78,5882,-1122,0,1122
Job_075,2,5632,7334,M2,5817,61,5878,-1456,0,1456
Job_065,6,5007,6887,M6,5831,40,5871,-1016,0,1016
Job_069,7,5241,6848,M5,5831,46,5877,-971,0,971
Job_052,7,3973,6037,M3,5838,98,5936,-101,0,101
Job_077,0,5840,7447,M0,5840,43,5883,-1564,0,1564
Job_056,9,4192,5894,M7,5849,45,5894,0,0,0
Job_074,5,5536,6780,M5,5877,11,5888,-892,0,892
Job_075,3,5632,7334,M6,5878,7,5885,-1449,0,1449
Job_071,0,5413,7477,M1,5882,81,5963,-1514,0,1514
Job_070,6,5408,6971,M0,5883,47,5930,-1041,0,1041
Job_077,1,5840,7447,M2,5883,90,5973,-1474,0,1474
Job_075,4,5632,7334,M8,5885,64,5949,-1385,0,1385
Job_074,6,5536,6780,M6,5888,62,5950,-830,0,830
Job_072,7,5419,6658,M7,5894,49,5943,-715,0,715
Job_063,9,4650,5961,M4,5906,55,5961,0,0,0
Job_052,8,3973,6037,M9,5936,22,5958,-79,0,79
Job_068,2,5187,7068,M3,5936,76,6012,-1056,0,1056
Job_067,8,5139,6837,M7,5943,36,5979,-858,0,858
Job_070,7,5408,6971,M6,5950,65,6015,-956,0,956
Job_072,8,5419,6658,M9,5958,72,6030,-628,0,628
Job_066,8,5038,6739,M4,5961,90,6051,-688,0,688
Job_078,0,5900,7689,M1,5963,91,6054,-1635,0,1635
Job_076,2,5760,7004,M2,5973,9,5982,-1022,0,1022
Job_058,9,4400,6007,M8,5977,30,6007,0,0,0
Job_069,8,5241,6848,M7,5979,72,6051,-797,0,797
Job_080,0,5986,7225,M2,5986,14,6000,-1225,0,1225
Job_052,9,3973,6037,M5,5994,43,6037,0,0,0
Job_080,1,5986,7225,M0,6000,6,6006,-1219,0,1219
Job_073,2,5420,7210,M3,6012,39,6051,-1159,0,1159
Job_075,5,5632,7334,M9,6030,76,6106,-1228,0,1228
Job_068,3,5187,7068,M5,6037,51,6088,-980,0,980
Job_065,7,5007,6887,M7,6051,89,6140,-747,0,747
Job_073,3,5420,7210,M2,6051,74,6125,-1085,0,1085
Job_076,3,5760,7004,M3,6051,36,6087,-917,0,917
Job_077,2,5840,7447,M4,6051,75,6126,-1321,0,1321
Job_078,1,5900,7689,M0,6054,85,6139,-1550,0,1550
Job_080,2,5986,7225,M1,6054,22,6076,-1149,0,1149
Job_080,3,5986,7225,M5,6088,61,6149,-1076,0,1076
Job_082,0,6090,7401,M1,6090,46,6136,-1265,0,1265
Job_068,4,5187,7068,M2,6125,85,6210,-858,0,858
Job_073,4,5420,7210,M8,6125,90,6215,-995,0,995
Job_076,4,5760,7004,M4,6126,49,6175,-829,0,829
Job_077,3,5840,7447,M9,6126,11,6137,-1310,0,1310
Job_079,0,5951,8014,M1,6136,81,6217,-1797,0,1797
Job_082,1,6090,7401,M0,6139,37,6176,-1225,0,1225
Job_080,4,5986,7225,M3,6149,26,6175,-1050,0,1050
Job_062,9,4613,6176,M7,6151,25,6176,0,0,0
Job_065,8,5007,6887,M4,6175,26,6201,-686,0,686
Job_076,5,5760,7004,M5,6175,11,6186,-818,0,818
Job_077,4,5840,7447,M3,6175,69,6244,-1203,0,1203
Job_074,7,5536,6780,M7,6176,56,6232,-548,0,548
Job_075,6,5632,7334,M5,6186,47,6233,-1101,0,1101
Job_076,6,5760,7004,M6,6186,62,6248,-756,0,756
Job_070,8,5408,6971,M4,6201,6,6207,-764,0,764
Job_068,5,5187,7068,M9,6210,11,6221,-847,0,847
Job_071,1,5413,7477,M2,6210,95,6305,-1172,0,1172
Job_059,9,4460,6249,M4,6216,33,6249,0,0,0
Job_074,8,5536,6780,M8,6232,44,6276,-504,0,504
Job_073,5,5420,7210,M5,6233,10,6243,-967,0,967
Job_073,6,5420,7210,M7,6243,12,6255,-955,0,955
Job_077,5,5840,7447,M1,6244,28,6272,-1175,0,1175
Job_082,2,6090,7401,M3,6244,61,6305,-1096,0,1096
Job_068,6,5187,7068,M6,6248,40,6288,-780,0,780
Job_080,5,5986,7225,M4,6249,69,6318,-907,0,907
Job_076,7,5760,7004,M7,6255,56,6311,-693,0,693
Job_073,7,5420,7210,M6,6288,89,6377,-833,0,833
Job_071,2,5413,7477,M0,6305,71,6376,-1101,0,1101
Job_075,7,5632,7334,M3,6305,52,6357,-977,0,977
Job_081,0,6053,7616,M2,6305,84,6389,-1227,0,1227
Job_068,7,5187,7068,M7,6311,89,6400,-668,0,668
Job_076,8,5760,7004,M8,6311,44,6355,-649,0,649
Job_080,6,5986,7225,M8,6355,21,6376,-849,0,849
Job_078,2,5900,7689,M3,6357,39,6396,-1293,0,1293
Job_071,3,5413,7477,M4,6376,99,6475,-1002,0,1002
Job_073,8,5420,7210,M9,6377,45,6422,-788,0,788
Job_077,6,5840,7447,M6,6377,46,6423,-1024,0,1024
Job_081,1,6053,7616,M1,6389,2,6391,-1225,0,1225
Job_082,3,6090,7401,M2,6389,13,6402,-999,0,999
Job_081,2,6053,7616,M5,6391,52,6443,-1173,0,1173
Job_080,7,5986,7225,M7,6400,49,6449,-776,0,776
Job_079,1,5951,8014,M2,6402,95,6497,-1517,0,1517
Job_064,9,4793,6491,M3,6412,79,6491,0,0,0
Job_082,4,6090,7401,M6,6423,32,6455,-946,0,946
Job_077,7,5840,7447,M5,6443,46,6489,-958,0,958
Job_084,0,6447,8327,M0,6447,76,6523,-1804,0,1804
Job_080,8,5986,7225,M9,6449,72,6521,-704,0,704
Job_068,8,5187,7068,M4,6475,26,6501,-567,0,567
Job_071,4,5413,7477,M6,6475,9,6484,-993,0,993
Job_085,0,6478,8179,M1,6478,85,6563,-1616,0,1616
Job_071,5,5413,7477,M8,6484,52,6536,-941,0,941
Job_077,8,5840,7447,M7,6489,72,6561,-886,0,886
Job_082,5,6090,7401,M5,6489,21,6510,-891,0,891
Job_081,3,6053,7616,M3,6491,95,6586,-1030,0,1030
Job_083,0,6233,7931,M2,6497,31,6528,-1403,0,1403
Job_075,8,5632,7334,M4,6501,90,6591,-743,0,743
Job_082,6,6090,7401,M9,6521,32,6553,-848,0,848
Job_079,2,5951,8014,M0,6523,71,6594,-1420,0,1420
Job_078,3,5900,7689,M2,6528,74,6602,-1087,0,1087
Job_060,9,4511,6574,M5,6531,43,6574,0,0,0
Job_071,6,5413,7477,M7,6561,85,6646,-831,0,831
Job_084,1,6447,8327,M1,6563,69,6632,-1695,0,1695
Job_081,4,6053,7616,M8,6586,48,6634,-982,0,982
Job_079,3,5951,8014,M4,6594,99,6693,-1321,0,1321
Job_083,1,6233,7931,M0,6594,86,6680,-1251,0,1251
Job_086,0,6579,8277,M2,6602,31,6633,-1644,0,1644
Job_072,9,5419,6658,M6,6605,53,6658,0,0,0
Job_084,2,6447,8327,M3,6632,76,6708,-1619,0,1619
Job_078,4,5900,7689,M8,6634,90,6724,-965,0,965
Job_081,5,6053,7616,M9,6634,72,6706,-910,0,910
Job_083,2,6233,7931,M1,6680,46,6726,-1205,0,1205
Job_085,1,6478,8179,M0,6680,13,6693,-1486,0,1486
Job_079,4,5951,8014,M6,6693,9,6702,-1312,0,1312
Job_085,2,6478,8179,M2,6693,61,6754,-1425,0,1425
Job_088,0,6681,8288,M0,6693,43,6736,-1552,0,1552
Job_066,9,5038,6739,M7,6694,45,6739,0,0,0
Job_084,3,6447,8327,M5,6708,51,6759,-1568,0,1568
Job_079,5,5951,8014,M8,6724,52,6776,-1238,0,1238
Job_086,1,6579,8277,M0,6736,86,6822,-1455,0,1455
Job_085,3,6478,8179,M6,6754,7,6761,-1418,0,1418
Job_088,1,6681,8288,M2,6754,90,6844,-1444,0,1444
Job_067,9,5139,6837,M3,6758,79,6837,0,0,0
Job_074,9,5536,6780,M9,6759,21,6780,0,0,0
Job_078,5,5900,7689,M5,6759,10,6769,-920,0,920
Job_078,6,5900,7689,M7,6769,12,6781,-908,0,908
Job_083,3,6233,7931,M5,6769,74,6843,-1088,0,1088
Job_078,7,5900,7689,M6,6781,89,6870,-819,0,819
Job_079,6,5951,8014,M7,6781,85,6866,-1148,0,1148
Job_069,9,5241,6848,M8,6783,30,6813,-35,0,35
Job_065,9,5007,6887,M8,6813,74,6887,0,0,0
Job_086,2,6579,8277,M1,6822,46,6868,-1409,0,1409
Job_087,0,6627,8508,M0,6822,76,6898,-1610,0,1610
Job_071,7,5413,7477,M3,6837,98,6935,-542,0,542
Job_083,4,6233,7931,M4,6843,32,6875,-1056,0,1056
Job_084,4,6447,8327,M2,6844,85,6929,-1398,0,1398
Job_086,3,6579,8277,M5,6868,74,6942,-1335,0,1335
Job_092,0,6860,8650,M1,6868,91,6959,-1691,0,1691
Job_078,8,5900,7689,M9,6870,45,6915,-774,0,774
Job_083,5,6233,7931,M6,6875,88,6963,-968,0,968
Job_088,2,6681,8288,M4,6875,75,6950,-1338,0,1338
Job_085,4,6478,8179,M8,6887,64,6951,-1228,0,1228
Job_081,6,6053,7616,M0,6898,47,6945,-671,0,671
Job_084,5,6447,8327,M9,6929,11,6940,-1387,0,1387
Job_091,0,6859,8098,M2,6929,14,6943,-1155,0,1155
Job_071,8,5413,7477,M9,6940,22,6962,-515,0,515
Job_089,0,6848,8411,M2,6943,84,7027,-1384,0,1384
Job_091,1,6859,8098,M0,6945,6,6951,-1147,0,1147
Job_070,9,5408,6971,M7,6946,25,6971,0,0,0
Job_086,4,6579,8277,M4,6950,32,6982,-1295,0,1295
Job_091,2,6859,8098,M1,6959,22,6981,-1117,0,1117
Job_092,1,6860,8650,M0,6959,85,7044,-1606,0,1606
Job_088,3,6681,8288,M9,6962,11,6973,-1315,0,1315
Job_081,7,6053,7616,M6,6963,65,7028,-588,0,588
Job_083,6,6233,7931,M8,6963,19,6982,-949,0,949
Job_088,4,6681,8288,M3,6973,69,7042,-1246,0,1246
Job_087,1,6627,8508,M1,6981,69,7050,-1458,0,1458
Job_091,3,6859,8098,M5,6981,61,7042,-1056,0,1056
Job_076,9,5760,7004,M9,6983,21,7004,0,0,0
Job_068,9,5187,7068,M8,6994,74,7068,0,0,0
Job_083,7,6233,7931,M9,7004,48,7052,-879,0,879
Job_081,8,6053,7616,M4,7028,6,7034,-582,0,582
Job_086,5,6579,8277,M6,7028,88,7116,-1161,0,1161
Job_091,4,6859,8098,M3,7042,26,7068,-1030,0,1030
Job_093,0,6976,8220,M0,7044,29,7073,-1147,0,1147
Job_089,1,6848,8411,M1,7050,2,7052,-1359,0,1359
Job_083,8,6233,7931,M7,7052,36,7088,-843,0,843
Job_085,5,6478,8179,M9,7052,76,7128,-1051,0,1051
Job_088,5,6681,8288,M1,7052,28,7080,-1208,0,1208
Job_089,2,6848,8411,M5,7052,52,7104,-1307,0,1307
Job_079,7,5951,8014,M3,7068,98,7166,-848,0,848
Job_091,5,6859,8098,M4,7068,69,7137,-961,0,961
Job_093,1,6976,8220,M1,7080,78,7158,-1062,0,1062
Job_086,6,6579,8277,M8,7116,19,7135,-1142,0,1142
Job_088,6,6681,8288,M6,7116,46,7162,-1126,0,1126
Job_085,6,6478,8179,M5,7128,47,7175,-1004,0,1004
Job_086,7,6579,8277,M9,7135,48,7183,-1094,0,1094
Job_091,6,6859,8098,M8,7137,21,7158,-940,0,940
Job_082,7,6090,7401,M8,7158,89,7247,-154,0,154
Job_091,7,6859,8098,M7,7158,49,7207,-891,0,891
Job_093,2,6976,8220,M2,7158,9,7167,-1053,0,1053
Job_094,0,7072,8774,M1,7158,85,7243,-1531,0,1531
Job_089,3,6848,8411,M3,7166,95,7261,-1150,0,1150
Job_080,9,5986,7225,M6,7172,53,7225,0,0,0
Job_088,7,6681,8288,M5,7175,46,7221,-1067,0,1067
Job_073,9,5420,7210,M4,7177,33,7210,0,0,0
Job_079,8,5951,8014,M9,7183,22,7205,-809,0,809
Job_095,0,7200,8444,M0,7200,29,7229,-1215,0,1215
Job_086,8,6579,8277,M7,7207,36,7243,-1034,0,1034
Job_091,8,6859,8098,M9,7207,72,7279,-819,0,819
Job_084,6,6447,8327,M6,7225,40,7265,-1062,0,1062
Job_094,1,7072,8774,M0,7243,13,7256,-1518,0,1518
Job_095,1,7200,8444,M1,7243,78,7321,-1123,0,1123
Job_082,8,6090,7401,M7,7247,30,7277,-124,0,124
Job_094,2,7072,8774,M2,7256,61,7317,-1457,0,1457
Job_089,4,6848,8411,M8,7261,48,7309,-1102,0,1102
Job_093,3,6976,8220,M3,7261,36,7297,-923,0,923
Job_096,0,7280,8887,M0,7280,43,7323,-1564,0,1564
Job_075,9,5632,7334,M7,7289,45,7334,0,0,0
Job_085,7,6478,8179,M3,7297,52,7349,-830,0,830
Job_093,4,6976,8220,M4,7297,49,7346,-874,0,874
Job_089,5,6848,8411,M9,7309,72,7381,-1030,0,1030
Job_094,3,7072,8774,M6,7317,7,7324,-1450,0,1450
Job_090,0,6853,8917,M1,7321,81,7402,-1515,0,1515
Job_095,2,7200,8444,M2,7321,9,7330,-1114,0,1114
Job_094,4,7072,8774,M8,7324,64,7388,-1386,0,1386
Job_096,1,7280,8887,M2,7330,90,7420,-1467,0,1467
Job_084,7,6447,8327,M7,7334,89,7423,-904,0,904
Job_082,9,6090,7401,M4,7346,55,7401,0,0,0
Job_093,5,6976,8220,M5,7346,11,7357,-863,0,863
Job_087,2,6627,8508,M3,7349,76,7425,-1083,0,1083
Job_093,6,6976,8220,M6,7357,62,7419,-801,0,801
Job_089,6,6848,8411,M0,7381,47,7428,-983,0,983
Job_094,5,7072,8774,M9,7388,76,7464,-1310,0,1310
Job_085,8,6478,8179,M4,7401,90,7491,-688,0,688
Job_097,0,7340,9129,M1,7402,91,7493,-1636,0,1636
Job_077,9,5840,7447,M8,7417,30,7447,0,0,0
Job_090,1,6853,8917,M2,7420,95,7515,-1402,0,1402
Job_093,7,6976,8220,M7,7423,56,7479,-741,0,741
Job_092,2,6860,8650,M3,7425,39,7464,-1186,0,1186
Job_089,7,6848,8411,M6,7428,65,7493,-918,0,918
Job_071,9,5413,7477,M5,7434,43,7477,0,0,0
Job_095,3,7200,8444,M3,7464,36,7500,-944,0,944
Job_087,3,6627,8508,M5,7477,51,7528,-980,0,980
Job_088,8,6681,8288,M7,7479,72,7551,-737,0,737
Job_093,8,6976,8220,M8,7479,44,7523,-697,0,697
Job_084,8,6447,8327,M4,7491,26,7517,-810,0,810
Job_097,1,7340,9129,M0,7493,85,7578,-1551,0,1551
Job_098,0,7391,9454,M1,7493,81,7574,-1880,0,1880
Job_099,0,7426,8665,M2,7515,14,7529,-1136,0,1136
Job_095,4,7200,8444,M4,7517,49,7566,-878,0,878
Job_094,6,7072,8774,M5,7528,47,7575,-1199,0,1199
Job_087,4,6627,8508,M2,7529,85,7614,-894,0,894
Job_089,8,6848,8411,M4,7566,6,7572,-839,0,839
Job_096,2,7280,8887,M4,7572,75,7647,-1240,0,1240
Job_101,0,7530,8841,M1,7574,46,7620,-1221,0,1221
Job_094,7,7072,8774,M3,7575,52,7627,-1147,0,1147
Job_095,5,7200,8444,M5,7575,11,7586,-858,0,858
Job_099,1,7426,8665,M0,7578,6,7584,-1081,0,1081
Job_090,2,6853,8917,M0,7584,71,7655,-1262,0,1262
Job_095,6,7200,8444,M6,7586,62,7648,-796,0,796
Job_081,9,6053,7616,M7,7591,25,7616,0,0,0
Job_087,5,6627,8508,M9,7614,11,7625,-883,0,883
Job_092,3,6860,8650,M2,7614,74,7688,-962,0,962
Job_099,2,7426,8665,M1,7620,22,7642,-1023,0,1023
Job_097,2,7340,9129,M3,7627,39,7666,-1463,0,1463
Job_099,3,7426,8665,M5,7642,61,7703,-962,0,962
Job_096,3,7280,8887,M9,7647,11,7658,-1229,0,1229
Job_087,6,6627,8508,M6,7648,40,7688,-820,0,820
Job_095,7,7200,8444,M7,7648,56,7704,-740,0,740
Job_101,1,7530,8841,M0,7655,37,7692,-1149,0,1149
Job_078,9,5900,7689,M4,7656,33,7689,0,0,0
Job_096,4,7280,8887,M3,7666,69,7735,-1152,0,1152
Job_092,4,6860,8650,M8,7688,90,7778,-872,0,872
Job_100,0,7493,9056,M2,7688,84,7772,-1284,0,1284
Job_090,3,6853,8917,M4,7689,99,7788,-1129,0,1129
Job_087,7,6627,8508,M7,7704,89,7793,-715,0,715
Job_096,5,7280,8887,M1,7735,28,7763,-1124,0,1124
Job_099,4,7426,8665,M3,7735,26,7761,-904,0,904
Job_101,2,7530,8841,M3,7761,61,7822,-1019,0,1019
Job_096,6,7280,8887,M6,7763,46,7809,-1078,0,1078
Job_097,3,7340,9129,M2,7772,74,7846,-1283,0,1283
Job_100,1,7493,9056,M1,7772,2,7774,-1282,0,1282
Job_100,2,7493,9056,M5,7774,52,7826,-1230,0,1230
Job_095,8,7200,8444,M8,7778,44,7822,-622,0,622
Job_099,5,7426,8665,M4,7788,69,7857,-808,0,808
Job_090,4,6853,8917,M6,7809,9,7818,-1099,0,1099
Job_090,5,6853,8917,M8,7822,52,7874,-1043,0,1043
Job_092,5,6860,8650,M5,7826,10,7836,-814,0,814
Job_092,6,6860,8650,M7,7836,12,7848,-802,0,802
Job_096,7,7280,8887,M5,7836,46,7882,-1005,0,1005
Job_101,3,7530,8841,M2,7846,13,7859,-982,0,982
Job_092,7,6860,8650,M6,7848,89,7937,-713,0,713
Job_083,9,6233,7931,M3,7852,79,7931,0,0,0
Job_087,8,6627,8508,M4,7857,26,7883,-625,0,625
Job_098,1,7391,9454,M2,7859,95,7954,-1500,0,1500
Job_090,6,6853,8917,M7,7874,85,7959,-958,0,958
Job_099,6,7426,8665,M8,7874,21,7895,-770,0,770
Job_094,8,7072,8774,M4,7883,90,7973,-801,0,801
Job_103,0,7887,9767,M0,7887,76,7963,-1804,0,1804
Job_097,4,7340,9129,M8,7895,90,7985,-1144,0,1144
Job_104,0,7918,9619,M1,7918,85,8003,-1616,0,1616
Job_100,3,7493,9056,M3,7931,95,8026,-1030,0,1030
Job_092,8,6860,8650,M9,7937,45,7982,-668,0,668
Job_101,4,7530,8841,M6,7937,32,7969,-872,0,872
Job_102,0,7673,9371,M2,7954,31,7985,-1386,0,1386
Job_099,7,7426,8665,M7,7959,49,8008,-657,0,657
Job_098,2,7391,9454,M0,7963,71,8034,-1420,0,1420
Job_079,9,5951,8014,M5,7971,43,8014,0,0,0
Job_103,1,7887,9767,M1,8003,69,8072,-1695,0,1695
Job_096,8,7280,8887,M7,8008,72,8080,-807,0,807
Job_101,5,7530,8841,M5,8014,21,8035,-806,0,806
Job_105,0,8019,9717,M2,8019,31,8050,-1667,0,1667
Job_090,7,6853,8917,M3,8026,98,8124,-793,0,793
Job_100,4,7493,9056,M8,8026,48,8074,-982,0,982
Job_098,3,7391,9454,M4,8034,99,8133,-1321,0,1321
Job_102,1,7673,9371,M0,8034,86,8120,-1251,0,1251
Job_097,5,7340,9129,M5,8035,10,8045,-1084,0,1084
Job_101,6,7530,8841,M9,8035,32,8067,-774,0,774
Job_091,9,6859,8098,M6,8045,53,8098,0,0,0
Job_100,5,7493,9056,M9,8074,72,8146,-910,0,910
Job_101,7,7530,8841,M8,8074,89,8163,-678,0,678
Job_097,6,7340,9129,M7,8080,12,8092,-1037,0,1037
Job_102,2,7673,9371,M1,8120,46,8166,-1205,0,1205
Job_104,1,7918,9619,M0,8120,13,8133,-1486,0,1486
Job_098,4,7391,9454,M6,8133,9,8142,-1312,0,1312
Job_104,2,7918,9619,M2,8133,61,8194,-1425,0,1425
Job_107,0,8121,9728,M0,8133,43,8176,-1552,0,1552
Job_085,9,6478,8179,M7,8134,45,8179,0,0,0
Job_097,7,7340,9129,M6,8142,89,8231,-898,0,898
Job_090,8,6853,8917,M9,8146,22,8168,-749,0,749
Job_098,5,7391,9454,M8,8163,52,8215,-1239,0,1239
Job_102,3,7673,9371,M5,8166,74,8240,-1131,0,1131
Job_105,1,8019,9717,M0,8176,86,8262,-1455,0,1455
Job_101,8,7530,8841,M7,8179,30,8209,-632,0,632
Job_107,1,8121,9728,M2,8194,90,8284,-1444,0,1444
Job_086,9,6579,8277,M3,8198,79,8277,0,0,0
Job_093,9,6976,8220,M9,8199,21,8220,0,0,0
Job_098,6,7391,9454,M7,8215,85,8300,-1154,0,1154
Job_088,9,6681,8288,M8,8223,30,8253,-35,0,35
Job_097,8,7340,9129,M9,8231,45,8276,-853,0,853
Job_104,3,7918,9619,M6,8231,7,8238,-1381,0,1381
Job_102,4,7673,9371,M4,8240,32,8272,-1099,0,1099
Job_084,9,6447,8327,M8,8253,74,8327,0,0,0
Job_100,6,7493,9056,M0,8262,47,8309,-747,0,747
Job_105,2,8019,9717,M1,8262,46,8308,-1409,0,1409
Job_102,5,7673,9371,M6,8272,88,8360,-1011,0,1011
Job_099,8,7426,8665,M9,8276,72,8348,-317,0,317
Job_103,2,7887,9767,M3,8277,76,8353,-1414,0,1414
Job_107,2,8121,9728,M4,8284,75,8359,-1369,0,1369
Job_108,0,8288,9851,M2,8288,84,8372,-1479,0,1479
Job_105,3,8019,9717,M5,8308,74,8382,-1335,0,1335
Job_111,0,8300,10090,M1,8308,91,8399,-1691,0,1691
Job_106,0,8067,9948,M0,8309,76,8385,-1563,0,1563
Job_098,7,7391,9454,M3,8353,98,8451,-1003,0,1003
Job_107,3,8121,9728,M9,8359,11,8370,-1358,0,1358
Job_100,7,7493,9056,M6,8360,65,8425,-631,0,631
Job_102,6,7673,9371,M8,8360,19,8379,-992,0,992
Job_110,0,8299,9538,M2,8372,14,8386,-1152,0,1152
Job_103,3,7887,9767,M5,8382,51,8433,-1334,0,1334
Job_105,4,8019,9717,M4,8382,32,8414,-1303,0,1303
Job_089,9,6848,8411,M7,8386,25,8411,0,0,0
Job_110,1,8299,9538,M0,8386,6,8392,-1146,0,1146
Job_110,2,8299,9538,M1,8399,22,8421,-1117,0,1117
Job_111,1,8300,10090,M0,8399,85,8484,-1606,0,1606
Job_108,1,8288,9851,M1,8421,2,8423,-1428,0,1428
Job_095,9,7200,8444,M9,8423,21,8444,0,0,0
Job_106,1,8067,9948,M1,8423,69,8492,-1456,0,1456
Job_100,8,7493,9056,M4,8425,6,8431,-625,0,625
Job_105,5,8019,9717,M6,8425,88,8513,-1204,0,1204
Job_103,4,7887,9767,M2,8433,85,8518,-1249,0,1249
Job_110,3,8299,9538,M5,8433,61,8494,-1044,0,1044
Job_087,9,6627,8508,M8,8434,74,8508,0,0,0
Job_102,7,7673,9371,M9,8444,48,8492,-879,0,879
Job_107,4,8121,9728,M3,8451,69,8520,-1208,0,1208
Job_112,0,8416,9660,M0,8484,29,8513,-1147,0,1147
Job_098,8,7391,9454,M9,8492,22,8514,-940,0,940
Job_102,8,7673,9371,M7,8492,36,8528,-843,0,843
Job_109,0,8293,10357,M1,8492,81,8573,-1784,0,1784
Job_108,2,8288,9851,M5,8494,52,8546,-1305,0,1305
Job_105,6,8019,9717,M8,8513,19,8532,-1185,0,1185
Job_103,5,7887,9767,M9,8518,11,8529,-1238,0,1238
Job_110,4,8299,9538,M3,8520,26,8546,-992,0,992
Job_103,6,7887,9767,M6,8529,40,8569,-1198,0,1198
Job_104,4,7918,9619,M8,8532,64,8596,-1023,0,1023
Job_105,7,8019,9717,M9,8532,48,8580,-1137,0,1137
Job_108,3,8288,9851,M3,8546,95,8641,-1210,0,1210
Job_110,5,8299,9538,M4,8546,69,8615,-923,0,923
Job_109,1,8293,10357,M2,8573,95,8668,-1689,0,1689
Job_112,1,8416,9660,M1,8573,78,8651,-1009,0,1009
Job_105,8,8019,9717,M7,8580,36,8616,-1101,0,1101
Job_104,5,7918,9619,M9,8596,76,8672,-947,0,947
Job_099,9,7426,8665,M6,8612,53,8665,0,0,0
Job_110,6,8299,9538,M8,8615,21,8636,-902,0,902
Job_092,9,6860,8650,M4,8617,33,8650,0,0,0
Job_110,7,8299,9538,M7,8636,49,8685,-853,0,853
Job_108,4,8288,9851,M8,8641,48,8689,-1162,0,1162
Job_111,2,8300,10090,M3,8641,39,8680,-1410,0,1410
Job_107,5,8121,9728,M1,8651,28,8679,-1049,0,1049
Job_109,2,8293,10357,M0,8668,71,8739,-1618,0,1618
Job_112,2,8416,9660,M2,8668,9,8677,-983,0,983
Job_104,6,7918,9619,M5,8672,47,8719,-900,0,900
Job_107,6,8121,9728,M6,8679,46,8725,-1003,0,1003
Job_113,0,8512,10214,M1,8679,85,8764,-1450,0,1450
Job_111,3,8300,10090,M2,8680,74,8754,-1336,0,1336
Job_112,3,8416,9660,M3,8680,36,8716,-944,0,944
Job_110,8,8299,9538,M9,8685,72,8757,-781,0,781
Job_106,2,8067,9948,M3,8716,76,8792,-1156,0,1156
Job_112,4,8416,9660,M4,8716,49,8765,-895,0,895
Job_107,7,8121,9728,M5,8725,46,8771,-957,0,957
Job_094,9,7072,8774,M7,8729,45,8774,0,0,0
Job_111,4,8300,10090,M8,8754,90,8844,-1246,0,1246
Job_108,5,8288,9851,M9,8757,72,8829,-1022,0,1022
Job_113,1,8512,10214,M0,8764,13,8777,-1437,0,1437
Job_112,5,8416,9660,M5,8771,11,8782,-878,0,878
Job_103,7,7887,9767,M7,8774,89,8863,-904,0,904
Job_113,2,8512,10214,M2,8777,61,8838,-1376,0,1376
Job_101,9,7530,8841,M4,8786,55,8841,0,0,0
Job_104,7,7918,9619,M3,8792,52,8844,-775,0,775
Job_106,3,8067,9948,M5,8792,51,8843,-1105,0,1105
Job_108,6,8288,9851,M0,8829,47,8876,-975,0,975
Job_113,3,8512,10214,M6,8838,7,8845,-1369,0,1369
Job_106,4,8067,9948,M2,8843,85,8928,-1020,0,1020
Job_111,5,8300,10090,M5,8844,10,8854,-1236,0,1236
Job_096,9,7280,8887,M8,8857,30,8887,0,0,0
Job_103,8,7887,9767,M4,8863,26,8889,-878,0,878
Job_107,8,8121,9728,M7,8863,72,8935,-793,0,793
Job_090,9,6853,8917,M5,8874,43,8917,0,0,0
Job_108,7,8288,9851,M6,8876,65,8941,-910,0,910
Job_113,4,8512,10214,M8,8887,64,8951,-1263,0,1263
Job_109,3,8293,10357,M4,8889,99,8988,-1369,0,1369
Job_106,5,8067,9948,M9,8928,11,8939,-1009,0,1009
Job_111,6,8300,10090,M7,8935,12,8947,-1143,0,1143
Job_112,6,8416,9660,M6,8941,62,9003,-657,0,657
Job_113,5,8512,10214,M9,8951,76,9027,-1187,0,1187
Job_108,8,8288,9851,M4,8988,6,8994,-857,0,857
Job_104,8,7918,9619,M4,8994,90,9084,-535,0,535
Job_109,4,8293,10357,M6,9003,9,9012,-1345,0,1345
Job_106,6,8067,9948,M6,9012,40,9052,-896,0,896
Job_109,5,8293,10357,M8,9012,52,9064,-1293,0,1293
Job_113,6,8512,10214,M5,9027,47,9074,-1140,0,1140
Job_100,9,7493,9056,M7,9031,25,9056,0,0,0
Job_111,7,8300,10090,M6,9052,89,9141,-949,0,949
Job_112,7,8416,9660,M7,9056,56,9112,-548,0,548
Job_113,7,8512,10214,M3,9074,52,9126,-1088,0,1088
Job_097,9,7340,9129,M4,9096,33,9129,0,0,0
Job_106,7,8067,9948,M7,9112,89,9201,-747,0,747
Job_112,8,8416,9660,M8,9112,44,9156,-504,0,504
Job_113,8,8512,10214,M4,9129,90,9219,-995,0,995
Job_111,8,8300,10090,M9,9141,45,9186,-904,0,904
Job_109,6,8293,10357,M7,9201,85,9286,-1071,0,1071
Job_106,8,8067,9948,M4,9219,26,9245,-703,0,703
Job_102,9,7673,9371,M3,9292,79,9371,0,0,0
Job_109,7,8293,10357,M3,9371,98,9469,-888,0,888
Job_098,9,7391,9454,M5,9411,43,9454,0,0,0
Job_109,8,8293,10357,M9,9469,22,9491,-866,0,866
Job_110,9,8299,9538,M6,9485,53,9538,0,0,0
Job_104,9,7918,9619,M7,9574,45,9619,0,0,0
Job_105,9,8019,9717,M3,9638,79,9717,0,0,0
Job_112,9,8416,9660,M9,9639,21,9660,0,0,0
Job_107,9,8121,9728,M8,9663,30,9693,-35,0,35
Job_103,9,7887,9767,M8,9693,74,9767,0,0,0
Job_108,9,8288,9851,M7,9826,25,9851,0,0,0
Job_106,9,8067,9948,M8,9874,74,9948,0,0,0
Job_111,9,8300,10090,M4,10057,33,10090,0,0,0
Job_113,9,8512,10214,M7,10169,45,10214,0,0,0
Job_109,9,8293,10357,M5,10314,43,10357,0,0,0
